
Excited about - Восхищен
Satisfied with - Удоволетворен
Disappointed about - Разочарован
Rely on - Положиться на
Let down - Подводить
Look forward to - Ждать с нетерпением
Purse - Кошелек
Obviously - Очевидно
Definetly - Определенно
Suppose - Предполагать
Suddenly - Случайно
Lead to - Приводить
Consist of - Состоит из
Managed to - Суметь
Succeeded in - Удалось
Refuse - Отказывать
Refusal - Отказ
Lack of - Нехватка
Confidence - Уверенность
Advantage - Преимущество
On purpose - С целью, Намеренно
Purpose - Цель (Цель жизни)
In fact - На самом деле
Mostly - В основном
For pleasure - Для удовольствия
In any case - В любом случае
On the whole - В целом
Attractive - Привлекательная
Unaccepteble - Неприемлемо
Shout at - Кричать на
Accuse of - Обвинять
Patience - Терпение
Insist on - Настаивать 
Belong to - Принадлежать
Strangely - Странно
Criticism - Критика
Issue - Проблема, вопрос
Complain to - Жаловаться на
Accident - случай
Somehow - как-то
Get in touch with someone - Связаться с кем-то
Biterly - Горько
Depend on - Зависеть от
Differ - отличаться 
Point out - Отметить
Addicted to - Зависим от
Prepare for - Готовится к
Immediatly - Немедленно
Suffers from - Страдать от
Illness - Болезнь
Introduce - Представлять, знакомить
Get rid of - Избавиться от
Completely - Полностью
Cure - Лечение, лекарство
Recovery - Восстанавливать
Desease - заболевание
Quite - Вполне
Enter - Входить, поступать, присоелиняться
Rude - Грубый
Notice - Заметить
Lend to - Одалживать
Cuisine - Кухня
Honestly - Честно говоря
Goal - Цель (буквально)
Habit - Привычка
Selfish - Эгоистичный
Calmly - Спокойно
Though - Хотя (разговорно)
Although - Хотя (формально)
Honestly - Честно говоря
At any rate - Во всяком случае (переносно)
Measure - Мера (Измерения)
At last - Наокнец
On business - По делам
Noon - Полдень
Satisfactory - Удоволетворительно
He finds it - Находит это
In cash - Наличными
By card - Картой
Patient - Пациент
The country - Сельская местность
Ground floor - Партер
Lie in bed - Лежать в кровати
Corner - Угол
Perhaps - Возможно
Break down - Ломаться
Try on - Примерять
Think over - Обдумывать
Put on - Одевать
Take off - Снимать
Hold on - Подождать (Wait)
Be out - Быть не дома 
Go on - Продолжать (Continue)
On a regular basis - На регулярной основе
Call off - Отменять (Cancel)
Be over - Заканчиваться (Finish)
Figure out - Понимать (Understand)
Sort out - Решить (Solve)
Left for - Уехать в
Get in - Входить, садится
Moved - Переехать
Call back - Перезвонить
Родился 1 Января - Was born on January 1
